16 16
4 4 4 4 4 4 4 4 4 4 4 4 4 4 4 4
4 4 4 4 4 4 4 4 4 4 4 4 4 4 4 4
4 4 0 0 0 0 0 0 0 0 0 0 0 0 4 4
4 4 0 0 6 6 6 6 6 6 6 0 0 0 4 4
4 4 0 6 6 6 6 6 6 6 6 6 0 0 4 4
4 4 0 6 6 6 6 6 6 6 6 6 0 0 4 4
4 4 0 6 6 6 6 6 6 6 6 6 0 0 4 4
4 4 0 6 6 6 6 6 6 6 6 6 0 0 4 4
4 4 0 6 6 6 6 6 6 6 6 6 0 0 4 4
4 4 0 6 6 6 6 6 6 6 6 6 0 0 4 4
4 4 0 6 6 6 6 6 6 6 6 6 0 0 4 4
4 4 0 0 0 0 0 0 0 0 0 0 0 0 4 4
4 4 0 0 0 0 0 0 0 0 0 0 0 0 4 4
4 4 0 0 0 0 0 0 0 0 0 0 0 0 4 4
4 4 4 4 4 4 4 0 4 4 4 4 4 4 4 4
4 4 4 4 4 4 4 0 4 4 4 4 4 4 4 4