12 12
17 14 14 14 14 14 14 14 14 14 14 20
13 12 12 12 12 12 12 12 12 12 12 15
13 12 12 12 12 12 12 12 12 12 12 15
13 12 12 12 12 12 12 12 12 12 12 15
13 12 12 12 12 12 12 12 12 12 12 15
13 12 12 12 12 12 12 12 12 12 12 15
13 12 12 12 12 12 12 12 12 12 12 15
13 12 12 12 12 12 12 12 12 12 12 15
13 12 12 12 12 12 12 12 12 12 12 15
13 12 12 12 12 12 12 12 12 12 12 15
13 12 12 12 12 12 12 12 12 12 12 15
18 16 16 16 16 16 67 16 16 16 16 19