4 4 4 4 4 4 4 4 4 4 4 4 4 4 4 4 4 4 4 4 4 4 4 4 4 4 4 4 4 4 4 4 4 4 4 4 4 4 4 4 4 4 4 4 4 4 4 4 4 4 
4 0 0 0 0 0 0 0 0 0 3 3 3 3 3 3 3 3 3 3 3 3 3 3 3 3 3 3 3 3 0 3 3 3 3 3 3 3 3 3 3 3 3 3 3 3 3 3 3 4 
4 1 1 0 0 0 0 0 0 0 0 0 0 0 0 0 0 0 0 0 0 0 0 0 0 0 0 0 0 0 6 6 6 6 6 6 6 6 6 6 6 6 6 6 6 6 6 6 3 4 
4 1 1 1 0 0 0 0 0 0 0 0 0 0 0 0 0 0 0 0 0 0 0 0 0 0 0 0 0 6 6 6 6 6 6 6 6 6 6 6 6 6 6 6 6 6 6 6 3 4 
4 0 1 1 1 0 0 0 0 0 0 0 0 0 0 0 0 0 0 0 0 0 0 0 0 0 0 0 0 0 6 6 6 6 6 6 6 6 6 6 6 6 6 6 6 6 6 6 3 4 
4 3 0 1 1 1 0 0 0 0 0 0 0 0 0 0 0 0 0 0 0 0 0 0 0 0 0 0 0 0 0 6 6 6 6 6 6 6 6 6 6 6 6 6 6 6 6 6 3 4 
4 3 0 0 1 1 1 0 0 0 0 0 0 0 0 0 0 0 0 0 0 0 0 0 0 0 0 0 0 0 0 0 6 6 6 6 6 6 6 6 6 6 6 6 6 6 6 6 3 4 
4 3 0 0 0 1 1 1 0 0 0 0 0 0 0 0 0 0 0 0 0 0 0 0 0 0 0 0 0 0 0 0 0 6 6 6 6 6 6 6 6 6 6 6 6 6 6 6 3 4 
4 3 0 0 0 0 1 1 1 1 1 1 1 1 1 1 1 1 1 1 1 1 1 0 0 0 0 0 0 0 0 0 0 0 6 6 6 6 6 6 6 6 6 6 6 6 6 6 3 4 
4 3 0 0 0 0 0 1 1 1 1 1 1 1 1 1 1 1 1 1 1 1 1 1 0 0 0 0 0 0 0 0 0 0 0 6 6 6 6 6 6 6 6 6 6 6 6 6 3 4 
4 3 0 0 0 0 0 0 0 0 0 0 0 0 0 0 0 0 0 0 0 1 1 1 1 0 0 0 0 0 0 0 0 0 0 6 6 6 6 6 6 6 6 6 6 6 6 6 3 4 
4 3 0 0 0 0 0 0 0 0 0 0 0 0 0 0 0 0 0 0 0 0 1 1 1 0 0 0 0 0 0 0 0 0 0 0 6 6 6 6 6 6 6 6 6 6 6 6 3 4 
4 3 0 0 0 0 0 0 0 0 0 0 0 0 0 0 0 0 0 0 0 0 1 1 1 0 0 0 0 0 0 0 0 0 0 0 0 6 6 6 6 6 6 6 6 6 6 6 3 4 
4 3 0 0 0 0 0 0 0 0 0 0 0 0 0 0 0 0 0 0 0 0 1 1 1 0 0 0 0 0 0 0 0 0 0 0 0 0 6 6 6 6 6 6 6 6 6 6 3 4 
4 3 0 0 0 0 0 0 0 0 0 0 0 0 0 0 0 0 0 0 0 0 1 1 1 0 0 0 0 0 0 0 0 0 0 0 0 0 0 0 6 6 6 6 6 6 6 6 3 4 
4 3 0 0 0 0 0 0 0 0 0 0 0 0 0 0 0 0 6 6 6 6 1 1 1 1 0 0 0 0 0 0 0 0 0 0 0 0 0 0 6 6 6 6 6 6 6 6 3 4 
4 3 0 0 0 0 0 0 0 0 0 0 0 0 0 0 0 6 6 6 6 1 1 1 1 1 1 0 0 0 0 0 0 0 0 0 0 0 0 0 0 6 6 6 6 6 6 6 3 4 
4 3 0 0 0 0 0 0 0 0 0 0 0 0 0 0 0 6 6 6 1 1 1 6 0 1 1 0 0 0 0 0 0 0 0 0 0 0 0 0 0 0 6 6 6 6 6 6 3 4 
4 3 0 0 0 0 0 0 0 0 0 0 0 0 0 6 6 6 6 1 1 1 6 6 0 0 1 1 0 0 0 0 0 0 0 0 0 0 0 0 0 0 6 6 6 6 6 6 3 4 
4 3 0 0 0 0 0 0 0 0 0 0 0 0 6 6 6 6 1 1 1 6 6 0 0 0 1 1 1 0 0 0 0 0 0 0 0 0 0 0 0 0 0 6 6 6 6 6 3 4 
4 3 0 0 0 0 0 0 0 0 0 0 0 6 6 6 6 1 1 1 6 6 0 0 0 0 1 1 1 0 0 0 0 0 0 0 0 0 0 0 0 0 0 6 6 6 6 6 3 4 
4 3 0 0 0 0 0 0 0 0 0 0 0 6 6 6 1 1 1 6 6 0 0 0 0 0 1 1 1 0 0 0 0 0 0 0 0 0 0 0 0 0 0 0 6 6 6 6 3 4 
4 3 0 0 0 0 0 0 0 0 0 0 6 6 6 1 1 1 6 6 0 0 0 0 0 0 1 1 1 0 0 0 0 0 0 0 0 0 0 0 0 0 0 0 0 6 6 6 3 4 
4 3 0 0 0 0 0 0 0 0 0 0 0 6 1 1 1 6 6 0 0 0 0 0 0 0 1 1 1 0 0 0 0 0 0 0 0 0 0 0 0 0 0 0 0 0 6 6 3 4 
4 3 0 0 0 0 0 0 0 0 0 0 0 1 1 1 6 6 0 0 0 0 0 0 0 0 1 1 1 0 0 0 0 0 0 0 0 0 0 0 0 0 0 0 0 0 0 6 3 4 
4 3 0 0 0 0 0 0 0 0 0 0 3 1 1 3 0 0 0 0 0 0 0 0 0 0 1 1 1 0 0 0 0 0 0 0 0 0 0 0 0 0 0 0 0 0 0 6 3 4 
4 3 0 0 0 0 0 0 0 0 0 0 2 1 1 2 0 0 0 0 0 0 0 0 0 0 1 1 1 0 0 0 0 0 0 0 0 0 0 0 0 0 0 0 0 0 0 6 3 4 
4 3 0 0 0 0 0 0 0 0 0 0 3 1 1 3 0 0 0 0 0 0 0 0 0 0 1 1 1 0 0 0 0 0 0 0 0 0 0 0 0 0 0 0 0 0 0 0 3 4 
4 3 0 0 0 0 0 0 0 0 0 0 2 1 1 2 0 0 0 0 0 0 0 0 0 0 3 1 3 0 0 0 0 0 0 0 0 0 0 0 0 0 0 0 0 0 0 0 3 4 
4 3 0 0 0 0 0 0 0 0 0 0 3 1 1 3 0 0 0 0 0 0 0 0 0 0 3 1 3 0 0 0 0 0 0 0 0 0 0 0 0 0 0 0 0 0 0 0 3 4 
4 3 0 0 0 0 0 0 0 0 0 0 2 1 1 2 0 0 0 0 0 0 0 0 0 0 3 1 3 3 3 3 3 3 3 3 0 0 0 0 0 0 0 0 0 0 0 0 3 4 
4 3 0 0 0 0 0 0 0 0 0 0 3 1 1 3 0 0 0 0 0 0 0 0 0 0 3 1 1 1 1 1 1 1 1 3 0 0 0 0 0 0 0 0 0 0 0 0 3 4 
4 3 0 0 0 0 0 0 0 0 0 0 0 1 1 0 0 0 0 0 0 0 0 0 0 0 3 3 3 3 3 3 3 3 1 3 0 0 0 0 0 0 0 0 0 0 0 0 3 4 
4 3 0 6 6 6 6 6 6 6 6 6 0 1 1 0 0 0 0 0 0 0 0 0 0 0 0 0 0 0 0 0 0 3 1 3 0 0 0 0 0 0 0 0 0 0 0 0 3 4 
4 3 0 6 6 6 6 6 6 6 6 6 0 1 1 0 0 0 0 0 0 0 0 0 0 0 0 0 0 0 0 0 0 3 1 3 0 0 0 0 0 0 0 0 0 0 0 0 3 4 
4 3 0 6 6 6 6 6 6 6 6 6 0 1 1 0 0 0 0 0 0 0 0 0 0 0 0 0 3 3 3 3 3 3 1 3 0 0 0 0 0 0 0 0 0 0 0 0 3 4 
4 3 0 6 6 6 6 6 6 6 6 6 0 1 1 0 0 0 0 0 0 0 0 0 0 0 0 0 3 1 1 1 1 1 1 3 0 0 0 0 0 0 0 0 0 0 0 0 3 4 
4 3 0 6 6 6 6 6 6 6 6 6 0 1 1 0 0 0 0 0 0 0 0 0 0 0 0 0 3 1 3 3 3 3 3 3 0 0 0 0 0 0 0 0 0 0 0 0 3 4 
4 3 0 6 6 6 6 6 6 6 6 6 0 1 1 0 0 0 0 0 0 0 0 0 0 0 0 0 3 1 3 0 0 0 0 0 0 0 0 0 0 3 3 0 0 0 0 0 3 4 
4 3 0 0 0 0 0 0 0 0 0 0 0 1 1 2 2 2 0 0 0 0 0 0 0 0 0 0 3 1 3 0 0 0 0 0 0 0 0 0 3 0 0 3 0 0 0 0 3 4 
4 3 0 5 5 5 5 5 5 5 5 5 5 0 0 5 5 2 0 0 0 0 0 0 0 0 0 0 3 1 3 0 0 0 0 0 0 0 0 3 1 1 1 1 3 0 0 0 3 4 
4 3 0 5 0 0 0 0 0 0 0 0 0 0 0 0 5 2 0 0 0 0 0 0 0 0 0 0 3 1 3 0 0 0 0 0 0 0 3 1 1 1 1 1 1 3 0 0 3 4 
4 3 0 5 0 0 0 0 0 0 0 0 0 0 0 0 5 2 0 0 0 0 0 0 0 0 0 0 2 1 2 2 2 2 2 2 2 2 1 1 1 1 1 1 1 1 3 0 3 4 
4 3 0 5 0 0 0 0 0 0 0 0 0 0 0 0 5 2 0 0 0 0 0 0 0 0 0 0 2 1 1 1 1 1 1 1 1 1 1 1 1 1 1 1 1 1 1 3 3 4 
4 3 0 5 0 0 0 0 0 0 0 0 0 0 0 0 5 2 0 0 0 0 0 0 0 0 0 0 2 2 2 2 2 2 2 2 2 2 1 1 1 1 1 1 1 1 3 0 3 4 
4 3 0 5 0 0 0 0 0 0 0 0 0 5 5 5 5 2 0 0 0 0 0 0 0 0 0 0 0 0 0 0 0 0 0 0 0 0 3 1 1 1 1 1 1 3 0 0 3 4 
4 3 0 5 5 5 5 5 5 5 5 5 5 5 0 0 0 0 0 0 0 0 0 0 0 0 0 0 0 0 0 0 0 0 0 0 0 0 0 3 1 1 1 1 3 0 0 0 3 4 
4 3 0 0 0 0 0 0 0 0 0 0 0 0 0 0 0 0 0 0 0 0 0 0 0 0 0 0 0 0 0 0 0 0 0 0 0 0 0 0 3 0 0 3 0 0 0 0 3 4 
4 3 3 3 3 3 3 3 3 3 3 3 3 3 3 3 3 3 3 3 3 3 3 3 3 3 3 3 3 3 3 3 3 3 3 3 3 3 3 3 3 3 3 3 3 3 3 3 3 4 
4 4 4 4 4 4 4 4 4 4 4 4 4 4 4 4 4 4 4 4 4 4 4 4 4 4 4 4 4 4 4 4 4 4 4 4 4 4 4 4 4 4 4 4 4 4 4 4 4 4 
