12 12
4 4 4 4 4 4 4 4 4 4 4 4
4 2 0 0 2 0 0 0 6 6 6 4
4 0 2 0 0 2 0 0 6 6 6 4
4 0 0 2 0 0 2 0 6 6 6 4
4 2 0 0 2 0 0 0 6 6 6 4
4 0 0 0 0 2 0 0 6 6 6 4
4 0 0 0 0 0 0 0 6 6 6 4
4 2 0 0 2 0 2 0 6 6 6 4
4 0 2 0 0 2 0 0 6 6 6 4
4 2 0 2 0 0 2 0 6 6 6 4
4 0 0 0 2 0 0 0 6 6 6 4
4 4 4 4 4 4 4 4 4 4 4 4