32 16
4 4 4 4 4 4 4 4 4 4 4 4 4 4 4 4 4 4 4 4 4 4 4 4 4 4 4 4 4 4 4 4
4 0 0 0 0 0 0 0 0 0 0 0 0 0 0 0 0 0 0 0 0 0 0 0 0 0 0 0 0 0 0 4
4 0 0 2 0 0 2 0 0 0 2 0 0 2 0 0 0 2 0 0 2 0 0 0 2 0 0 2 0 0 0 4
4 0 2 0 0 2 0 0 2 0 0 2 0 0 2 0 2 0 0 2 0 0 2 0 0 2 0 0 2 0 0 4
4 0 0 0 2 0 0 2 0 0 2 0 0 2 0 0 0 0 2 0 0 2 0 0 2 0 0 2 0 0 0 4
4 0 0 2 0 0 2 0 0 2 0 0 2 0 0 2 0 2 0 0 2 0 0 2 0 0 2 0 0 0 0 4
4 0 2 0 0 2 0 0 2 0 0 2 0 0 2 0 0 0 0 2 0 0 2 0 0 2 0 0 2 0 0 4
4 0 0 0 0 0 0 0 0 0 0 0 0 0 0 0 0 0 0 0 0 0 0 0 0 0 0 0 0 0 0 4
4 6 6 6 6 6 6 6 6 6 6 6 6 6 6 6 6 6 6 6 6 6 6 6 6 6 6 6 6 6 6 4
4 6 6 6 6 6 6 6 6 6 6 6 6 6 6 6 6 6 6 6 6 6 6 6 6 6 6 6 6 6 6 4
4 6 6 6 6 6 6 6 6 6 6 6 6 6 6 6 6 6 6 6 6 6 6 6 6 6 6 6 6 6 6 4
4 6 6 6 6 6 6 6 6 6 6 6 6 6 6 6 6 6 6 6 6 6 6 6 6 6 6 6 6 6 6 4
4 6 6 6 6 6 6 6 6 6 6 6 6 6 6 6 6 6 6 6 6 6 6 6 6 6 6 6 6 6 6 4
4 6 6 6 6 6 6 6 6 6 6 6 6 6 6 6 6 6 6 6 6 6 6 6 6 6 6 6 6 6 6 4
4 6 6 6 6 6 6 6 6 6 6 6 6 6 6 6 6 6 6 6 6 6 6 6 6 6 6 6 6 6 6 4
4 4 4 4 4 4 4 4 4 4 4 4 4 4 4 4 4 4 4 4 4 4 4 4 4 4 4 4 4 4 4 4