32 16
70 70 70 70 70 70 70 0 70 70 70 70 70 70 70 70 70 70 70 70 70 70 70 70 70 70 70 70 70 70 70 70
70 0 0 0 0 0 0 0 0 70 0 0 0 0 0 0 0 0 0 0 0 0 0 0 0 0 70 0 0 0 0 70
70 0 70 0 0 0 0 0 0 0 0 0 0 0 70 0 0 0 0 0 70 0 0 0 0 0 0 0 0 0 0 70
70 0 0 0 0 0 0 70 0 0 0 0 0 0 0 0 0 0 70 0 0 0 0 0 0 0 0 0 70 0 0 70
69 68 68 68 68 68 68 68 68 69 68 68 68 68 68 68 68 68 68 68 68 68 69 68 68 68 68 68 68 68 68 69
69 68 69 68 68 68 68 68 68 68 68 68 68 68 68 68 69 68 68 68 68 68 68 68 68 68 68 69 68 68 68 69
69 68 68 68 68 68 68 68 69 68 68 68 68 69 68 68 68 68 68 69 68 68 68 68 68 68 68 68 68 68 68 69
69 68 68 68 69 68 68 68 68 68 68 68 68 68 68 68 68 68 68 68 68 68 68 69 69 68 68 68 68 69 68 69
6 6 6 6 6 6 6 6 6 6 6 6 6 6 6 6 6 6 6 6 6 6 6 6 6 6 6 6 6 6 6 6
6 6 6 6 6 6 6 6 6 6 6 6 6 6 6 6 6 6 6 6 6 6 6 6 6 6 6 6 6 6 6 6
6 6 6 6 6 6 6 6 6 6 6 6 6 6 6 6 6 6 6 6 6 6 6 6 6 6 6 6 6 6 6 6
6 6 6 6 6 6 6 6 6 6 6 6 6 6 6 6 6 6 6 6 6 6 6 6 6 6 6 6 6 6 6 6
6 6 6 6 6 6 6 6 6 6 6 6 6 6 6 6 6 6 6 6 6 6 6 6 6 6 6 6 6 6 6 6
6 6 6 6 6 6 6 6 6 6 6 6 6 6 6 6 6 6 6 6 6 6 6 6 6 6 6 6 6 6 6 6
6 6 6 6 6 6 6 6 6 6 6 6 6 6 6 6 6 6 6 6 6 6 6 6 6 6 6 6 6 6 6 6
6 6 6 6 6 6 6 6 6 6 6 6 6 6 6 6 6 6 6 6 6 6 6 6 6 6 6 6 6 6 6 6